[20,20]
(5,12)
(2,1)
(4,2,1,5)
(1,0,1,1)
(5,4,4,6)
(1,1,1,1)
(0,0,1,1)
