[20,20]
(0,6)
(2,6)
(1,0,1,1)
(0,7,2,4)
(0,1,1,1)
(4,5,8,4)
(1,7,5,4)
(0,0,1,1)
(0,1,1,1)
(1,1,1,1)
(0,0,1,1)
(1,0,1,1)
