[20,20]
(0,6)
(14,8)
(10,0,3,6)
(1,6,6,1)
(7,2,1,1)
(4,1,6,4)
(0,0,1,1)
(5,2,1,1)
(5,4,4,1)
(0,1,9,3)
(2,8,8,8)
