[20,20]
(4,3)
(8,0)
(1,8,6,2)
(4,9,8,9)
(4,1,2,1)
(0,0,1,1)
(1,5,2,2)
