[20,20]
(0,0)
(12,14)
(6,3,4,7)
(6,8,4,9)
(7,5,5,3)
(10,0,1,1)
(4,0,4,3)
(6,1,2,9)
(8,3,5,6)
