[20,20]
(3,3)
(5,11)
(3,4,1,1)
(4,1,1,1)
(0,4,1,1)
(3,5,2,8)
(2,5,1,8)
