[20,20]
(15,9)
(0,15)
(5,1,2,3)
(2,3,2,2)
(6,4,5,8)
(0,0,1,1)
(0,0,1,1)
(0,0,1,1)
(0,0,1,1)
(5,5,3,9)
