[10,10]
(9,8)
(7,5)
(0,0,2,2)
(1,4,2,2)
(4,4,3,4)
(3,8,1,1)
(2,4,1,2)
(1,4,2,1)
(2,7,3,3)
