[10,10]
(1,2)
(8,1)
(3,5,1,2)
(4,3,3,1)
(5,0,3,1)
(2,1,1,1)
(0,0,1,1)
