[10,10]
(2,1)
(9,9)
(5,1,1,1)
(4,2,2,2)
(6,3,2,1)
(6,6,2,4)
(6,7,1,3)
