[10,10]
(1,7)
(2,3)
(0,0,1,1)
(5,4,1,4)
(5,6,3,1)
(0,1,3,2)
(0,0,1,1)
(1,1,1,1)
(7,5,3,1)
