[10,10]
(3,0)
(4,1)
(6,0,2,4)
(5,1,1,3)
(5,0,4,3)
(0,0,1,1)
(5,6,2,3)
(8,5,1,4)
