[10,10]
(4,9)
(7,2)
(1,5,3,4)
(2,3,4,3)
(1,3,2,1)
(6,6,1,1)
(0,0,1,1)
(7,5,2,4)
