[10,10]
(9,5)
(0,2)
(1,6,3,1)
(2,0,4,3)
(2,0,3,2)
(7,8,2,1)
(6,1,4,1)
