[10,10]
(4,7)
(9,5)
(5,8,3,1)
(2,4,1,1)
(3,1,1,1)
(1,0,2,3)
(8,1,2,1)
(9,7,1,1)
