[10,10]
(3,8)
(9,4)
(7,6,2,2)
(0,2,1,1)
(0,1,1,3)
(5,0,4,1)
(1,1,1,1)
