[10,10]
(5,4)
(0,9)
(8,5,2,3)
(8,9,1,1)
(0,0,1,1)
(8,7,2,3)
(0,0,1,1)
(0,0,1,1)
