[10,10]
(4,7)
(0,2)
(2,5,1,1)
(0,0,1,1)
(0,0,1,1)
(0,0,1,1)
(7,0,1,1)
(0,0,1,1)
(1,8,3,2)
