[10,10]
(8,1)
(9,4)
(0,2,2,4)
(4,3,2,1)
(2,5,4,2)
(0,2,1,1)
(0,2,4,4)
