[10,10]
(3,0)
(3,5)
(6,1,2,3)
(8,8,2,2)
(4,1,1,3)
(1,1,1,1)
(0,1,1,1)
